....................................................................................................
.0000000000000000000000000-........00000000000000000@@@@@@@@@@@@000000000000000000000000000000000001
.00000000000000000000000000@-...+0000000000000000000000000000000000000000000000000000000000000000001
.000000000000000000000000000000000000000000000000000000000000000000000000000000000000000000000000001
.000000000000000000000000000000000000000000000000000000000000000000000000000000000000000000000000001
.0000000000000000000000000000000000#0000000000000000000000000000000000000000000000000000000000000001
.00000000000000000000000#...........+00000000#000000000000000000000000000000000000000000000000000001
.0000000000000000000000-............00000000-.+00000000000000000000000000000000000000000000000000001
.0000000000000000000000-............000000000@00000000000000000000000000#000000000000000000000000001
.0000000000000000000000-............00000000000000000000000000000000000-.+00000000000000000000000001
.0000000000000000000000-............0000000000000000000000000000000000000000000000000000000#00000001
.0000000000000000000000-............000000000000000000000000000000000000000000000000000000-.+0000001
.0000000000000000000000-............00000000000000000000000000000000000000000000000000000-..+0000001
.0000000000000000000000-............#############00000000000000000000000000000000000000-....+0000001
.0000000000000000000000-.........................##0000000000000000000###0000000000000-.....+0000001
....................................................................................................